111111111111111111111
1P00000000000000000E1
101110C01110111011101
100100101010100010101
100100101110101010101
100100101010111011101
100000000000000000001
111111111111111111111
